1111111111
1........1
1........1
1.p...b.t1
1.....b.t1
1........1
1........1
1........1
1........1
1111111111