111111111111111
1.b.b.b.b.b.b1
1bbbbbbbbbbbbb1
1.b.b.b.b.b.b.1
1bbbbbbbbbbbbb1
1.b.b.b.b.b.b.1
1bbbbbbbbbbbbb1
1.b.b.b.b.b.b.1
1bbbbbbbbbbbbb1
1pb.b.b.b.b.b.1
1bbbbbbbbbbbbb1
1pb.b.b.b.b.b.1
1bbbbbbbbbbbbb1
1pb.b.b.b.b.b.1
111111111111111
